SPPPPWWPPPPWWWW
WWPWPWWPWWPWWWW
WWPWPPPPPWPPPPP
WWPPWWWWPWWWPWW
WWWWWWWWPPPPPWW
WWWWWWWWPWWWWWW
WWWWWWWWPWWWWWW
WWWWWWPPPWWWWWW
WWWWWPPWWPPPPWW
WWWWPPWWWPWWPWW
WWWWPWWPPPWPPPP
WWWWPWWPWWPPWWW
WWWWPPPPWWPWWWW
WWWWWWWWWWPWPPP
WWWWWWWPPPPPPWF