SPPPPWWPPPPWWWW
WWPWPWWPWWPWWWW
WWPWPPPPPWPPPPP
WWPPWWWWPWWWPWW
WWWWWWWWPPPPPWW
WWPWPPPPPWWWWWW
WWPWPWWWPWWWWWW
WPPWPWPPPWWWWWW
WPWWWPPWWPPPPWW
WPPPPPWWWPWWPWW
WWWWPWWPPPWPPPP
WWWWPWWPWWPPWWW
WWWWPPPPWWPWWWW
WWWWPWWWWWPWPPP
WWPPPWWPPPPPPWF